BWWWWWWWWWWWWWWWWWR
W--------X--------W
W-------EEE-------W
W--W-----------W--W
W-WWWE-------EWWW-W
W--W-----------W--W
W-----------------W
W---EEEEEEEEEEE---W
W-----------------W
W--------P--------W
RWWWWWWWWWWWWWWWWWB