BWWWWWWWWWWWWWWWWWR
W-----------------W
W----W-------W----W
W---WWW--E--WWW---W
W----W-------W----W
W--------X--------W
W----W-------W----W
W---WWW--E--WWW---W
W----W-------W----W
W--------P--------W
RWWWWWWWWWWWWWWWWWB