BWWWWWWWWWWWWWWWWWR
W-----------------W
W--------------X--W
W-----------------W
W---------WWWWWWWWW
W-----------------W
W-----------------W
WWWWWWWWWW----X---W
W-----------------W
W-P---------------W
RWWWWWWWWWWWWWWWWWB