BWWWWWWWWWWWWWWWWWR
W-----------------W
W-----------------W
W----WWWWWWWWW----W
W----E-------E----W
W----W---P---W----W
W----EWE---EWE----W
W-----------------W
W----EEEWWWEEE----W
W--------X--------W
RWWWWWWWWWWWWWWWWWB