BWWWWWWWWWWWWWWWWWR
W-----------------W
W--------------X--W
W-----------------W
W---------WWWWWWWWW
W----E------------W
W-----------------W
WWWWWWWWWW--------W
W-----------------W
W-P---------------W
RWWWWWWWWWWWWWWWWWB