WWWWWWWWWWW
W---------W
W----R----W
W---------W
W----B----W
W---------W
W----Y----W
W---------W
W---------W
WWWWWWWWWWW