BWWWWWWWWWWWWWWWWWR
W--X-----------E--W
WWWWWWW-----------W
W-E---------------W
W------WWWWWWWWWWWW
W---------E-------W
W-E---------------W
WWWWWWWWWWWWW-----W
W-----------------W
W-P-----------E---W
RWWWWWWWWWWWWWWWWWB