BWWWWWWWWWWWWWWWWWR
W---------------Y-W
W---WWWWWWWWWWWWWWW
W-----------------W
WWWWWWWWWWWW--WWWWW
W-----------------W
WWW--WWWWWWWWWWWWWW
W-----------------W
WWWWWWWWWWWWW--WWWW
W--------P--------W
RWWWWWWWWWWWWWWWWWB