BWWWWWWWWWWWWWWWWWR
W-----------------W
WWWWWW----E-------W
W--------------WWWW
W-----E------E----W
W--------XW-------W
WWWW-----WWW-E----W
W---------W-E-----W
W--------------WWWW
W-----P-----------W
RWWWWWWWWWWWWWWWWWB