BWWWWWWWWWWWWWWWWWR
W--------X--------W
W-----------------W
W-----------------W
W--------W--------W
W-------WWW-------W
W--------W--------W
W-----------------W
W-----------------W
W--------P--------W
RWWWWWWWWWWWWWWWWWB