BWWWWWWWWWWWWWWWWWR
W--E--------------W
W---E-EE--E--E--E-W
W----E---X--------W
W-E----------E----W
WE-E------E-------W
W-----E--------E-EW
W---------E-------W
WE----P------E----W
W-----E--------E--W
RWWWWWWWWWWWWWWWWWB