BWWWWWWWWWWWWWWWWWR
W-----------------W
W-WWWWWWWWWWWWWWW-W
W-W-------------W-W
W-W-WWWWWWWWWWW-W-W
W-W-W----X----W-w-W
W-W-----------W-W-W
W-WWWWWWWWWWWWW-W-W
W-----------------W
W--P--------------W
RWWWWWWWWWWWWWWWWWB