BWWWWWWWWWWWWWWWWWR
W--P-----------E--W
WWWWWWW-----------W
W-E---------------W
W------WWWWWWWWWWWW
W---------E-------W
W-E---------------W
WWWWWWWWWWWWW-----W
W-----------------W
W-X-----------E---W
RWWWWWWWWWWWWWWWWWB