BWWWWWWWWWWWWWWWWWR
W-----------------W
W----E---------X--W
W-----------------W
W---------WWWWWWWWW
W----E------------W
W-----------------W
WWWWWWWWWW----E---W
W----X------------W
W-P---------------W
RWWWWWWWWWWWWWWWWWB