BWWWWWWWWWWWWWWWWWR
W--------P--------W
W-----------------W
W-----------------W
W-----------------W
W-----------------W
W-----------------W
W-----------------W
W-----------------W
W--------X--------W
RWWWWWWWWWWWWWWWWWB