BWWWWWWWWWWWWWWWWWR
W-----------------W
W-----------------W
W-----------------W
W-----------------W
W-----------------W
W-----------------W
W-----------------W
W-----------------W
W-----------------W
RWWWWWWWWWWWWWWWWWB