BWWWWWWWWWWWWWWWWWR
W-----------------W
W----E---------X--W
W--------E--------W
W---------WWWWWWWWW
W----E------------W
W-----------------W
WWWWWWWWWW----E--WW
W----E------------W
W-P---------------W
RWWWWWWWWWWWWWWWWWB