BWWWWWWWWWWWWWWWWWR
W-----------------W
W---WW----E-------W
W--------------WWWW
W-----E------E----W
W--------P--------W
WWWW-----WWW-E----W
W----------E------W
W--------------WWWW
W-----X-----------W
RWWWWWWWWWWWWWWWWWB