BWWWWWWWWWWWWWWWWWR
W------E--------X-W
W---WW-------WWWWWW
W-----------------W
WWWW--E-------WWWWW
W-----------------W
WWW--WW---------WWW
W-------------E---W
WWWWWW---------WWWW
W--------P------X-W
RWWWWWWWWWWWWWWWWWB